7 12
############
#S........T#
#.########.#
#..........#
#..........#
#..#..#....#
############
