7 15
###############
#S......#T....#
#.###########.#
#.......#.#...#
#######.#.....#
#..#......#...#
###############
