5 8
########
#......#
#.####.#
#...T#S#
########
