5 8
########
#.#S...#
#.####.#
#...T#.#
########
